1568.00
1.1875
1
8
black_horizontal
black_vertical
black_top_left
black_top_right
black_bottom_left
black_bottom_right
black_flag
green_single
1,1,1;1,0,1;1,0,1;1,0,1;1,0,1;1,0,1;1,0,1;1,0,1;1,0,1;1,0,1;1,0,1;1,0,1;1,0,1;1,0,1;1,0,1;1,0,1;1,0,1;1,0,1;1,1,1
554.40
50
dbsus2.wav
0,0,0;0,0,0;0,8,0;0,0,0;0,0,0;0,0,0;0,0,0;0,0,0;0,0,0;0,0,0;0,0,0;0,0,0;0,8,0;0,0,0;0,0,0;0,0,0;0,0,0;0,0,0;0,0,0
784.00
50
gmaj7.wav
0,0,0;0,0,0;0,0,0;0,0,0;0,0,0;0,0,0;0,0,0;0,0,0;0,8,0;0,0,0;0,0,0;0,0,0;0,0,0;0,0,0;0,0,0;0,0,0;0,0,0;0,0,0;0,0,0
932.32
50
bbm7.wav
0,0,0;0,0,0;0,0,0;0,0,0;0,8,0;0,0,0;0,0,0;0,0,0;0,0,0;0,0,0;0,8,0;0,0,0;0,0,0;0,0,0;0,0,0;0,0,0;0,8,0;0,0,0;0,0,0
1174.72
50
e7.wav
0,0,0;0,0,0;0,0,0;0,0,0;0,0,0;0,0,0;0,8,0;0,0,0;0,0,0;0,0,0;0,0,0;0,0,0;0,0,0;0,0,0;0,8,0;0,0,0;0,0,0;0,0,0;0,0,0
1568.00
50
c.wav
3,1,4;2,0,2;2,0,2;2,0,2;2,0,2;2,0,2;2,0,2;2,0,2;2,0,2;2,0,2;2,0,2;2,0,2;2,0,2;2,0,2;2,0,2;2,0,2;2,0,2;2,7,2;5,1,6
